####################################################
#    #   #   #  #  #    #     #     #     #     ####
#    #   #   #  #  #    #     #     #     #   ##  ##
##############################################    ##
###  #   #   #  #  #    #     #     #    ###     # #
###  #   #   #  #  #    #     #     #  ##       #  #
###  #   #   #  #  #    #     #     ###         #  #
###############################   ###           #  #
###   #   #  #  #  #    #     # ##             #   #
###   #   #  #  #  #    #     ##              #    #
###   #   #  #  #  #    #  ###                #    #
###########################                   #    #
####  #   #  #  #  #   ##                    #     #
####  #   #  #  #  # ##                     #      #
#####################                       #      #
#  #    #    #    # #                       #      #
#  #    #    #    #  #                     #       #
##################    #                   #        #
#  #    #    #   #    #                   #        #
#  #    #    #  #      #                  #        #
#  #    #    #  #       #                #         #
################         #              #          #
#  #    #    # #          #             #          #
#  #    #    ##            #            #          #
#  #    #    ##             #          #           #
##############               #        #            #
#  #    #    #               #        #            #
#  #    #   #                 #       #            #
#  #    #   #                  #     #             #
############                    #   #              #
#  #    #  #                     #  #              #
#  #    # #                       # #              #
#  #    # #                        #               #
#  #    ##                       ###               #
#  #    ##                     ##   #              #
#########                    ##      #             #
#  #    #                  ##         #            #
#  #   #                 ##            #           #
#  #   #                #               #          #
#  #  #               ##                 #         #
#######             ##                   #         #
#  # #            ##                      #        #
#  # #          ##                         #       #
#  ##         ##                            #      #
#  ##       ##                               #     #
#  #       #                                  #    #
#  #     ##                                    #   #
# #    ##                                       #  #
# #  ##                                         #  #
#####                                            # #
###                                               ##
####################################################
16