##################################################################################
##                                      #                                       ##
##                                      #                                      ###
###                                     #                                      ###
###                           ######    #                                     # ##
## #                        ##      ########                                 #  ##
##  #                    ###            #   ########                        ## ###
##  #                  ##               #           #####                  ##  ###
##   #              ###                 #                #                ##   # #
# #   #          ###                    #                 ##              #   ## #
# #   #        ##                       #                   #            ##   ## #
# #    #    ###                         #                    #          ##    ## #
# #    #  ##                            #                     ##       ##    ##  #
# #     ##                              #                       #     ##     #   #
# #     #                               #                        #    #      #   #
#  #    ##                              #                         ## #      #    #
#  #    ##                              #                          ##       #    #
#  #    # #                             #                          ###      #    #
#  #    # #                             #                    #########      #    #
#  #    # #                             #               #####     ## #     #     #
#   #   #  #                            #         ######         #   #     #     #
#   #   #  #                           #     #####              #    #     #     #
#   #   #   #                          ######                 ##     #    #      #
#   #   #   #                     ######                     #       #    #      #
#   #   #   #               ######     #                    #        #    #      #
#   #   #    #         #####           #                   #         #   #       #
#    #  #    #   ######                #                 ##          #   #       #
#    #  #     ###                      #                #            #   #       #
#    #  #     ####                     #               #             #  #        #
#    #  #     #   #                    #             ##              #  #        #
#    #  #     #    ###                 #            #                #  # ########
#    #  #    #        #                #           #                 #  # #      #
#     # #    #         ###             #         ##                  # #  #      #
#     # #    #            #            #        #                    # # ##      #
#     # #    #             ###         #       #                     # # ##      #
#     # #    #                #        #      #                      ##  ##      #
#     # #   #                  ###     #    ##                        #  #       #
#     # #   #                     #    #   #                          #  #       #
#      ##   #                      ### #  #                           #  #       #
#      ##   #                         ####             ################ ##       #
#      ################################################               # #        #
#      #    #                         ##  #                           # #        #
#      #   #                         # #   ###                        # #        #
#      #   #                       ##  #      #                       # #        #
#      #   #                      #    #       ###                    ###        #
#      #   #                     #     #          #                   ##         #
#      #   #                   ##      #           ###                ##         #
#      #  #                   #        #              #               ##         #
#      #  #                  #         #               ###            ##         #
#      #  #                 #          #                  #           ##         #
#      #  #               ##           #                   ###        #          #
#      #  #              #             #                      #       #          #
#      # #              #              #                       ###    #          #
#      # #            ##               #                          #   #          #
#      # #           #                 #                           ####          #
#      # #          #                  #                             ##          #
#      # #        ##                   #                         ######          #
#      # #       #                     #                      ###    # #         #
#      ##       #                      #                  ####     ##  #         #
#      ##      #                       #               ###        #     #        #
#      ##    ##                        #            ###          #      #        #
#      ##   #                         #         ####           ##        #       #
#      ##  #                          #      ###              #          #       #
#      ####                           #  ####                #           #       #
#      ##              ##################                   #             #      #
#      ################               #                   ##              #      #
#      #                              #                  #                 #     #
#     #                               #                 #                  #     #
#     #                               #               ##                    #    #
#    #                                #              #                      #    #
#    #                                #             #                       #    #
#   #                                 #            #                         #   #
#   #                                 #          ##                          #   #
#   #                                 #         #                             #  #
#  #                                  #        #                              #  #
#  #                                  #       #                               #  #
# #                                   #     ##                                 # #
# #                                   #    #                                   # #
##                                    #   #                                     ##
##                                    # ##                                      ##
#                                     ##                                         #
##################################################################################
10