##################################################################################
##                 ###                 ####                 ###                 ##
# #               # # #               # ## #               # # #               # #
#  #             #  #  #             #  ##  #             #  #  #             #  #
#   #           #   #   #           #   ##   #           #   #   #           #   #
#    #         #    #    #         #    ##    #         #    #    #         #    #
#     #       #     #     #       #     ##     #       #     #     #       #     #
#      #     #      #      #     #      ##      #     #      #      #     #      #
#       #   #       #       #   #       ##       #   #       #       #   #       #
#        # #        #        # #        ##        # #        #        # #        #
#         #         #         #         ##         #         #         #         #
#        # #        #        # #        ##        # #        #        # #        #
#       #   #       #       #   #       ##       #   #       #       #   #       #
#      #     #      #      #     #      ##      #     #      #      #     #      #
#     #       #     #     #       #     ##     #       #     #     #       #     #
#    #         #    #    #         #    ##    #         #    #    #         #    #
#   #           #   #   #           #   ##   #           #   #   #           #   #
#  #             #  #  #             #  ##  #             #  #  #             #  #
# #               # # #               # ## #               # # #               # #
##                 # #                 #  #                 # #                 ##
###################   #################    #################   ###################
##                 # #                 #  #                 # #                 ##
# #               # # #               # ## #               # # #               # #
#  #             #  #  #             #  ##  #             #  #  #             #  #
#   #           #   #   #           #   ##   #           #   #   #           #   #
#    #         #    #    #         #    ##    #         #    #    #         #    #
#     #       #     #     #       #     ##     #       #     #     #       #     #
#      #     #      #      #     #      ##      #     #      #      #     #      #
#       #   #       #       #   #       ##       #   #       #       #   #       #
#        # #        #        # #        ##        # #        #        # #        #
#         #         #         #         ##         #         #         #         #
#        # #        #        # #        ##        # #        #        # #        #
#       #   #       #       #   #       ##       #   #       #       #   #       #
#      #     #      #      #     #      ##      #     #      #      #     #      #
#     #       #     #     #       #     ##     #       #     #     #       #     #
#    #         #    #    #         #    ##    #         #    #    #         #    #
#   #           #   #   #           #   ##   #           #   #   #           #   #
#  #             #  #  #             #  ##  #             #  #  #             #  #
# #               # # #               # ## #               # # #               # #
##                 ###                 ####                 ###                 ##
##################################################################################
##################################################################################
##                 ###                 ####                 ###                 ##
# #               # # #               # ## #               # # #               # #
#  #             #  #  #             #  ##  #             #  #  #             #  #
#   #           #   #   #           #   ##   #           #   #   #           #   #
#    #         #    #    #         #    ##    #         #    #    #         #    #
#     #       #     #     #       #     ##     #       #     #     #       #     #
#      #     #      #      #     #      ##      #     #      #      #     #      #
#       #   #       #       #   #       ##       #   #       #       #   #       #
#        # #        #        # #        ##        # #        #        # #        #
#         #         #         #         ##         #         #         #         #
#        # #        #        # #        ##        # #        #        # #        #
#       #   #       #       #   #       ##       #   #       #       #   #       #
#      #     #      #      #     #      ##      #     #      #      #     #      #
#     #       #     #     #       #     ##     #       #     #     #       #     #
#    #         #    #    #         #    ##    #         #    #    #         #    #
#   #           #   #   #           #   ##   #           #   #   #           #   #
#  #             #  #  #             #  ##  #             #  #  #             #  #
# #               # # #               # ## #               # # #               # #
##                 # #                 #  #                 # #                 ##
###################   #################    #################   ###################
##                 # #                 #  #                 # #                 ##
# #               # # #               # ## #               # # #               # #
#  #             #  #  #             #  ##  #             #  #  #             #  #
#   #           #   #   #           #   ##   #           #   #   #           #   #
#    #         #    #    #         #    ##    #         #    #    #         #    #
#     #       #     #     #       #     ##     #       #     #     #       #     #
#      #     #      #      #     #      ##      #     #      #      #     #      #
#       #   #       #       #   #       ##       #   #       #       #   #       #
#        # #        #        # #        ##        # #        #        # #        #
#         #         #         #         ##         #         #         #         #
#        # #        #        # #        ##        # #        #        # #        #
#       #   #       #       #   #       ##       #   #       #       #   #       #
#      #     #      #      #     #      ##      #     #      #      #     #      #
#     #       #     #     #       #     ##     #       #     #     #       #     #
#    #         #    #    #         #    ##    #         #    #    #         #    #
#   #           #   #   #           #   ##   #           #   #   #           #   #
#  #             #  #  #             #  ##  #             #  #  #             #  #
# #               # # #               # ## #               # # #               # #
##                 ###                 ####                 ###                 ##
##################################################################################
10